  #######   
  #..x..#   
  #.....####
###..O.O..x#
#..........#
#x.O.@...###
#........#  
####..O..#  
   #x....#  
   #######  