#############
#...........#
####xxOxx####
####xx#xx####
#....OOO....#
#.....O.....#
#....OOO....#
#..###@....##
#############