 #####
 #.@.###
##.#O..#
#.GX.X.#
#..OO.##
###.#X#
  #...#
  #####