 ##########  
 #....@...###
##.##..O....#
#..Gx..x.##.#
#......O.O.##
###.##.x.### 
  #......#   
  ########   