############
#..........#
#.....O...@#
#####G.....#
#....G..####
#....G....##
#....G....# 
#....x....# 
########### 