  ####
  #..#
###O.##
#..G.@#
#..G..#
#..G.##
###G.#
  #X##
  ###