#######    
#.....#####
#.#.#.....#
#.O...O...#
#xx###O#O##
#x@O.....# 
#xx....### 
########   