#####
#...#####
#.#.#...#
#.O...O.#
#XX#O#O##
#X@O...#
#XX..###
######