 ############ 
 #..........##
##x####...O..#
#.xx....O....#
#..#O...###..#
#..@....###..#
##############