 ######
 #....##
##X##O.#
#.XXO..#
#..#O..#
#..@.###
######