###########  
#.........#  
#.O@..#...###
#.OO#.....#x#
###.....###x#
 ##........x#
 #......#...#
 #.......####
 #########   