 ##########
##........#
#...@.O...#
##..O....##
##...O...#
#x..O....#
#xxGx....#
##########