 ####
##..#
#.@O#
##O.##
##.O.#
#xO..#
#xxGx#
######