  ########   
  #......### 
  #.@......# 
###O..#....##
#x#...#.....#
#xO...#.....#
#x........O.#
#############