  ######
  #....#
###OOO.#
#..OXX.#
#@OXXX##
####..#
   ####