  ##########
  #........#
###..OOO...#
#....Oxx...#
#@..Oxxx..##
####......# 
   ######## 