  #####
###...#
#...G.##
#.OXOX.#
###.XO.#
  #.@.##
  #####