  ##########
###........#
#.....G...##
#..O..O....#
###...xx...#
  #..@....##
  ######### 