  ####
  #XX#
 ##.G##
 #..@X#
##...O##
#..#OO.#
#......#
########