  ############  
  #xx..##....#  
 ##.G........## 
 #....@..x....# 
##........O...##
#..###...OO....#
#..............#
################