################
#..###.....##..#
#.....OxxO.....#
#@....OxG.....##
#.....OxxO.....#
#..###.....##..#
################