############
#..........#
#.OOO.....##
#..#xx##### 
##..xxO...##
 #........@#
 ###########