######
#....#
#.OOO##
#..#XX###
##..XXO.#
 #.@....#
 ########